32131232321312311213331222132333331312113312311331213121111232121132123222333112
13233122132331331323321212332121212321113332222332213212122323132223232331231312
12131233331223312233312223221212213111311211213113222333121112313113132213313232
12232212232321321132213121113312312232223233233112233112131213333222132331213222
22213323132113123321322321123323133231131113313111321333233312321113332322222222
13312132311312321233333122121333121323331321111122112221122231132221313333332212
13213313211211213133111211113323121133322222323232331131332123213212213321123212
32222312313331133221211233231333212132332122332133332231333213121121331232221222
33133113131232131123123323231113212312332133132231233133133332321133322111112332
12313111133311321133133311312211233131211111313113331211322211223223312221311212
33122333333212122332131313323321121333122212313112232122332311122231311121121332
32333332331312132311113332213113232312213222312233222111232333232111323213212312
23321121212112212132311131132122333233123123221323323333333112123231212122231122
21131223321331233132213123211212123331321333131111121111311132322332312321332332
31223331223332131221233211231233132122323312312313221121311311112212221132233132
23333132112123321322123112312223123112331221311121332211133311121131222331112132
22312321122233233231111231113313323121333333222213222313233211332322131332212122
12332212232133222132123332311121121323213321122223213333132211332132331113323312
31312333122232221332313133123131122333113311331222311113311331331333222211211222
33233112221222232321333332222213213212213233322311233221111113312332322123231132
23311121223121221312233132123121223332322313122311112331123321312313132132113212
33233313233111111222131121323311211232212333331123213212321121132213113132212222
13112231132312331122232321313313312213331333212112122111332111222232113333311322
23321332111331132223111233112211332133122132312232111232333311311211121312321222
22222233211112131212112232321332232123211223333313333131212111321311322322312122
13333212211111132312313133223221222331132111113323321321332333312311332232223312
22111313211232321131223233313121213331321211122222213232322321123132223111323212
13332312211313311333213112123321212132312221122212311231113322322323221113213322
22233232313223112212321333312221322122122323123213231322113121311131133212333132
32233212313233221222113321131123123111222212111123231312232323321112122311213332
32223233112123132112322232323331213111222211212222111223331213332211212121123212
22113331323132321131211113133233222311312211231312112333333212211121233321131222
32212332313333131332212123323121231313331212213312213222121321233311213331333212
32322231133313131323322333312312131123231123122322131121313312121313123131223212
33131312123312213322311223111322331311123221131311321312222212122211221312213232
13123311212311133111132112132311113222211233221313123311232112131132123111232332
13313123133322222132332113211313111332323231211222311132113211331121211323333132
23331221113133322311111221123312133121123322112231322213231312332333123311133212
12223212311323331121322322222231222122133222131231322131313222223132233323232132
31222131332232213223123323323211211132132231233231333223313213123221121331133232
22133112212113231232133131232123132223323321222123212212111221223211312221331312
33113323131331223211212133331213223213111311221323123332323233321222323213211212
31123112223231321231113123332311231322212333331231331121221212133311213321321312
12113123132233311122223323333332212222331323333231213131123132323233322333122232
21211332122323223123131111111311233111332321232322322122223211213121312331313232
31312213313231113231213232331323213113321323211313313211121223322331223231331212
31112231312131333121333121222231111133232113111113133311122322111111311113332132
31331212223132211113213213133232333321213233221333312311312232232233232213313122
12122222221123122222132322333113223122112212311111333133122331311312332211113132
12131223213211131221131223222221333121323332121223313212123113211123122333121222
22223233111231312131313223333323223222223112113233112321312213223231321312333232
31222331233112131132122211113212231211121333332222212213331332222213232233112232
33222132331132132321213213223333322311322213232332313113313333112221122132311232
33233211113322211233211132213312233311133312313311132213313113213132131133322222
32321221112131333321322213332131223331231331111131133323212221123223232111123112
12131222311331213323131313123132221212131331212231332232222323312222312223211332
12221122123322231133322212213223233122111121333222312121132113213121223323113212
32132322122123331212121213321321322211113231311231312131113113133223211112221222
23311222322313213123121233121122211232111131123321132321211212333231211311312132
11221121231133332311322211213323133111233121112131331213333321132321333312233322
33322233223133131323123123213323213111112322323123232222311233332222123321332322
13233123331313233232311112321312131222222122331123323111232312133313322223133332
11213331312223332132313133122222132313112213133311333313322123331123233221112332
32322331223311133113123212322123221331212113133233322321112132131332333232333112
12223331113112121112113133123321221122213233213231321113332121233223121312112122
22323333121213331221233221212221212222111221133333232223231313323313321221111112
12112321131221321113121112211121132121313332312132133331323231133313112221223112
13311123213212113121133111311221133322212121232333123222121213322212213112112222
23322212231132122133121333311212221311233332223231322132311331322221333313123132
32323213332121132113232333311113111333211133311132211123322323333311231121312132
11333313112332331231322131133312122213213131212111131312111332213221131333322132
11221231212321332122133311132331212332332321321311223331331223332222333222331232
32111311131332113232232131321111131312111323122323312222132311322131133322211132
33322122131331321133232233222232233223111322122331133132113313131313213332333132
33221233111122232233113332122222312112131211231211221222231231221221321212233322
11321112211332333223221111121212233112222212321221332212333333211313323333222332
33212132332123133332232212232211232212132233232133232333211233233332133322112312
22323222231121131313231131231311233322111121212111222122323232233233213233133232
11323121311311213231313332321311121313232332312312221231231112332121312113331332
11111111111111111111111111111111111111111111111111111111111111111111111111111110
